1 3 4 3 3 1 0 3 3
4 3 0 1 4 3 5 0 0
0 4 3 5 1 1 0 1 1
5 1 1 4 1 3 4 3 1
3 5 0 5 0 4 1 1 3
– – – – – – – – –
3 4 5 0 5 1 1 0 3
1 5 1 5 0 0 4 0 4
