4 5 1 5 4
5 1 4 1 3
3 4 3 3 5
3 1 4 1 5
4 3 1 5 4
